.....**......**....
....*.*......*.*...
....*..........*...
.**.*..........*.**
.**.*.*..**..*.*.**
....*.*.*..*.*.*...
....*.*.*..*.*.*...
.**.*.*..**..*.*.**
.**.*..........*.**
....*..........*...
....*.*......*.*...
.....**......**....x