............*..*...............
...........*...................
...........*...*...............
...**......****................
..****.........................
.**.**.........................
..**.....**.***................
........*.....**.......*....***
.......**.......*......*....*.*
........*.....**.......*....***
..**.....**.***................
.**.**.........................
..****.........................
...**......****................
...........*...*...............
...........*...................
............*..*...............x